XXXXXXX XXXXXXX
X.............X
X.............X
X.............X
X.............X
X.............X
X.............X
 ......e...... 
X.............X
X.............X
X.............X
X.............X
X.............X
X.............X
XXXXXXX XXXXXXX